000000000000000000000000000000000000000000000000000000000000000000000000000000000000000000000000000000000000000000000000000000
000000000000000000000000000000000000000000000000000000000000000000000000000000000000000000000000000000000000000000000000000000
000000000000000000000000000000000000000000000000000000000000000000000000000000000000000000000000000000000000000000000000000000
000000000000000000000000000000000000000000000000000000000000000000000000000000000000000000000000000000000000000000000000000000
000000000000000000000000000000000000000000000000000000000000000000000000000000000000000000000000000000000000000000000000000000
000000000000000000000000000000000000000000000000000000000000000000000000000000000000000000000000000000000000000000000000000000
000000000000000000000000000000000000000000000000000000000000000000000000000000000000000000000000000000000000000000000000000000
000000000000000000000000000000000000000000000000000000000000000000000000000000000000000000000000000000000000000000000000000000
000000000000000000000000000000000000000000000000000000000000000000000000000000000000000000000000000000000000000000000000000000
000000000000000000000000000000000000000000000000000000000000000000000000000000000000000000000000000000000000000000000000000000
000000000000000000000000000000000000000000000000000000000000000000000000000000000000000000000000000000000000000000000000000000
000000000000000000000000000000000000000000000000000000000000000000000000000000000000000000000000000000000000000000000000000000
000000030000000000000000000000000000000000000000000000000000000300000000000000000000000000000000000000000000000000000000000000
000000000000000000000000000000000000000000000000000000000000000000000000000000000000000000000000000000000000000000000000000000
000000000000000000000000000000000000000000000000000000000000000000000000000000000000000000000000000000000000000000000000000000
000000111111111111111111111111111111111111111111111111111111111111111111111111111111111111111111111111111111111111111000000000
000000111111111111111111111111111111111111111111111111111111111111111111111111111111111111111111111111111111111111111000000000
000000111111111111111111111111111111111111111111111111111111111111111111111111111111111111111111111111111111111111111000000000
000000111111111111111111111111111111111111111111111111111111111111111111111111111111111111111111111111111111111111111000000000
000000111100000000000000000000000000001111111111111111111111111111111111111111111111111111111111111111111111111111111000000000
000000111100000000000000000000000000001111111111111100000000000000000000001111111111111110000000000000000000000111111000000000
000000111100000000000000000000000000001111111111111100000000000000000000001111111111111110000000000000000000000111111000000000
000000111100000000000000000000000000001111111111111100000000000000000000001111111111111110000000000000000000000111111000000000
000000111100000000000000000000000000001111111111111100000000000000000000001111111111111110000000000000000000000111111000000000
000000111100000000000000000000000000001111111111111100000000000000000000001111111111111110000000000000000000000111111000000000
000000111100000000000000000000000000001111111111111100000000000000000000001111111211111110000000000000000000000111111000000000
000000111100000000000000000000000000001111111111111100000000000000000000001111111011111110000000000000000000000111111000000000
000000111100000000000000000000000000001111111111111100000000000000000000001111111011111110000000000000000000000111111000000000
000000111100000000000000000000000000001111111111111100000000000000000000001111111011111110000000000000000000000111111000000000
000000111100000000000000000000000000001111111111111100000000000000000000001111111011111110000000000000000000000111111000000000
000000111100000000000000000000000000000000000000000000000000000000000000000000000000000000000000000000000000000111111000000000
000000111100000000000000000000000000000000000000000000000000000000000000000000000000000000000000000000000000000111111000000000
000000111100000000000000000000000000000000000000000000000000000000000000000000000000000000000000000000000000000111111000000000
000000111100000000000000000000000000000000000000000000000000000000000000000000000000000000000000000000000000000111111000000000
000000111100000000000000000000000000000000000000000000000000000000000000000000000000000000000000000000000000000111111000000000
000000111100000000000000000000000000000000000000000000000000000000000000000000000000000000000000000000000000000111111000000000
000000111100000000000000000000000000000000000000000000000000000000000000000000000000000000000000000000000000000111111000000000
00000011110000000000000b0000000000000000000000000000000000000004000000000000000000000000000000000000a0000000000111111000000000
000000111111111111111111111111111111111111111111111111111111111111111111111111111111111111111111111111111111111111111000000000
000000111111111111111111111111111111111111111111111111111111111111111111111111111111111111111111111111111111111111111000000000
000000111111111111111111111111111111111111111111111111111111111111111111111111111111111111111111111111111111111111111000000000
000000111111111111111111111111111111111111111111111111111111111111111111111111111111111111111111111111111111111111111000000000
000000110000000000000000000000000000001111111111111111111111111111111111111111111111111111111111111111111111111111111000000000
000000110000000000000000000000000000001111111111111100000000000000000000001111111111111100000000000000000000000111111000000000
000000110000000000000000000000000000001111111111111100000000000000000000001111111111111100000000000000000000000111111000000000
000000110000000000000000000000000000001111111111111100000000000000000000001111111111111100000000000000000000000111111000000000
000000110000000000000000000000000000001111111111111100000000000000000000001111111111111100000000000000000000000111111000000000
000000110000000000000000000000000000001111111111111100000000000000000000001111111111111100000000000000000000000111111000000000
000000110000000000000000000000000000001111112111111100000000000000000000001111111111111100000000000000000000000111111000000000
000000110000000000000000000000000000001111110111111100000000000000000000001111111111111100000000000000000000000111111000000000
000000110000000000000000000000000000001111110111111100000000000000000000001111111111111100000000000000000000000111111000000000
000000110000000000000000000000000000001111110111111100000000000000000000001111111111111100000000000000000000000111111000000000
000000110000000000000000000000000000001111110111111100000000000000000000000000000000000000000000000000000000000111111000000000
000000110000000000000000000000000000000000000000000000000000000000000000000000000000000000000000000000000000000111111000000000
000000110000000000000000000000000000000000000000000000000000000000000000000000000000000000000000000000000000000111111000000000
000000110000000000000000000000000000000000000000000000000000000000000000000000000000000000000000000000000000000111111000000000
000000110000000000000000000000000000000000000000000000000000000000000000000000000000000000000000000000000000000111111000000000
000000110000000000000000000000000000000000000000000000000000000000000000000000000000000000000000000000000000000111111000000000
000000110000000000000000000000000000000000000000000000000000000000000000000000000000000000000000000000000000000111111000000000
0000001100000000000000000000000000000000000000000000000000000000000000000000000000000000000000000000c0000000000111111000000000
000000110000000000000000000000000000000000000000000000000000000d00000000001111111111111111111111111111111111111111111000000000
00000011000000000000000B000000000000001111111111111111111111111111111111111111111111111111111111111111111111111111111000000000
000000111111111111111111111111111111111111111111111111111111111111111111111111111111111111111111111111111111111111111000000000
000000111111111111111111111111111111111111111111111111111111111111111111111111111111111111111111111111111111111111111000000000
000000111111111111111111111111111111111111111111111111111111111111111111111111111111111111111111111111111111111111111000000000
000000111111111111111111111111111111111111111111111111111111111111111111111111111111111111111111111111111111111111111000000000
000000111111111111111111111111111111111111111111111110000000000000000000011111111111111111111111111111111111111111111000000000
000000111111111111111111111111111111111111111111111110000000000000000000011111111111111110000000000000000000000111111000000000
000000111100000000000000000000000000001111111111111110000000000000000000011111111111111110000000000000000000000111111000000000
000000111100000000000000000000000000001111111111111110000000000000000000011111111111111110000000000000000000000111111000000000
000000111100000000000000000000000000001111111111111110000000000000000000011111111111111110000000000000000000000111111000000000
000000111100000000000000000000000000001111111111111110000000000000000000011111111111111110000000000000000000000111111000000000
000000111100000000000000000000000000001111111211111110000000000000000000011111111211111110000000000000000000000111111000000000
000000111100000000000000000000000000001111111011111110000000000000000000011111111011111110000000000000000000000111111000000000
000000111100000000000000000000000000001111111011111110000000000000000000011111111011111110000000000000000000000111111000000000
000000111100000000000000000000000000001111111011111110000000000000000000011111111011111110000000000000000000000111111000000000
000000111100000000000000000000000000000000000000000000000000000000000000000000000000000000000000000000000000000111111000000000
000000111100000000000000000000000000000000000000000000000000000000000000000000000000000000000000000000000000000111111000000000
000000111100000000000000000000000000000000000000000000000000000000000000000000000000000000000000000000000000000111111000000000
000000111100000000000000000000000000000000000000000000000000000000000000000000000000000000000000000000000000000111111000000000
000000111100000000000000000000000000000000000000000000000000000000000000000000000000000000000000000000000000000111111000000000
000000111100000000000000000000000000000000000000000000000000000000000000000000000000000000000000000000000000000111111000000000
0000001111000000000000D00000000000000000000000000000000000000006000000000000000000000000000000000000C0000000000111111000000000
000000111111111111111111111111111111111111111111111111111111111511111111111111111111111111111111111111111111111111111000000000
000000111111111111111111111111111111111111111111111111111111111111111111111111111111111111111111111111111111111111111000000000
000000111111111111111111111111111111111111111111111111111111111111111111111111111111111111111111111111111111111111111000000000
000000111111111111111111111111111111111111111111111111111111111111111111111111111111111111111111111111111111111111111000000000
000000111111111111111111111111111111111111111111111111111111111111111111111111111111111111111111111111111111111111111000000000
000000111111111111111111111111111111111111111111111111111111111111111111111111111111111111111111111111111111111111111000000000
000000000000000000000000000000000000000000000000000000000000000000000000000000000000000000000000000000000000000000000000000000
000000000000000000000000000000000000000000000000000000000000000000000000000000000000000000000000000000000000000000000000000000
000000000000000000000000000000000000000000000000000000000000000000000000000000000000000000000000000000000000000000000000000000
000000000000000000000000000000000000000000000000000000000000000000000000000000000000000000000000000000000000000000000000000000
000000000000000000000000000000000000000000000000000000000000000000000000000000000000000000000000000000000000000000000000000000
000000000000000000000000000000000000000000000000000000000000000000000000000000000000000000000000000000000000000000000000000000
000000000000000000000000000000000000000000000000000000000000000000000000000000000000000000000000000000000000000000000000000000
000000000000000000000000000000000000000000000000000000000000000000000000000000000000000000000000000000000000000000000000000000
000000000000000000000000000000000000000000000000000000000000000000000000000000000000000000000000000000000000000000000000000000
000000000000000000000000000000000000000000000000000000000000000000000000000000000000000000000000000000000000000000000000000000
000000000000000000000000000000000000000000000000000000000000000000000000000000000000000000000000000000000000000000000000000000
000000000000000000000000000000000000000000000000000000000000000000000000000000000000000000000000000000000000000000000000000000
000000000000000000000000000000000000000000000000000000000000000000000000000000000000000000000000000000000000000000000000000000
000000000000000000000000000000000000000000000000000000000000000000000000000000000000000000000000000000000000000000000000000000
000000000000000000000000000000000000000000000000000000000000000000000000000000000000000000000000000000000000000000000000000000
000000000000000000000000000000000000000000000000000000000000000000000000000000000000000000000000000000000000000000000000000000
000000000000000000000000000000000000000000000000000000000000000000000000000000000000000000000000000000000000000000000000000000
000000000000000000000000000000000000000000000000000000000000000000000000000000000000000000000000000000000000000000000000000000
000000000000000000000000000000000000000000000000000000000000000000000000000000000000000000000000000000000000000000000000000000
000000000000000000000000000000000000000000000000000000000000000000000000000000000000000000000000000000000000000000000000000000
000000000000000000000000000000000000000000000000000000000000000000000000000000000000000000000000000000000000000000000000000000
000000000000000000000000000000000000000000000000000000000000000500000000000000000000000000000000000000000000000000000000000000
000000000000000000000000000000000000000000000000000000000000000000000000000000000000000000000000000000000000000000000000000000
000000000000000000000000000000000000000000000000000000000000000000000000000000000000000000000000000000000000000000000000000000
000000000000000000000000000000000000000000000000000000000000000000000000000000000000000000000000000000000000000000000000000000
000000000000000000000000000000000000000000000000000000000000000000000000000000000000000000000000000000000000000000000000000000
000000000000000000000000000000000000000000000000000000000000000000000000000000000000000000000000000000000000000000000000000000
000000000000000000000000000000000000000000000000000000000000000000000000000000000000000000000000000000000000000000000000000000
